28 26 26 26 26 26 26 26 26 26 26 26 26 26 26 26 26 26 26 26 26 26 26 29 18
24 00 00 00 00 32 00 32 32 16 16 00 00 00 32 00 00 16 16 00 32 38 16 23 18
30 22 32 00 00 32 12 10 10 10 10 10 13 16 00 32 00 32 32 16 32 32 00 25 29
19 30 21 22 16 16 08 03 03 03 03 03 07 16 00 00 00 00 00 00 16 00 00 16 23
18 18 19 30 22 16 08 03 03 03 03 03 07 32 16 32 00 32 16 32 32 16 00 32 23
18 18 18 18 24 32 08 03 03 03 03 03 07 16 00 00 16 00 00 16 00 16 16 16 23
28 26 29 19 24 00 14 05 06 03 04 05 15 32 00 32 00 32 32 16 32 00 32 00 23
24 00 23 28 27 00 00 16 08 03 07 16 00 00 00 00 16 32 00 00 16 00 00 38 23
30 21 31 24 16 16 16 16 08 03 07 16 00 32 00 00 00 16 16 00 32 00 00 00 23
19 18 28 27 32 32 00 12 11 03 07 16 32 32 00 32 16 00 16 32 32 32 16 00 23
28 26 27 00 00 16 00 08 03 03 07 16 16 00 16 00 16 32 00 00 00 00 16 16 23
24 38 12 10 10 10 10 11 03 04 15 00 32 32 16 32 00 32 32 00 32 00 16 20 31
24 16 08 03 03 03 03 03 03 07 16 16 16 16 00 00 00 38 16 16 16 00 20 31 18
24 16 14 05 05 05 05 05 05 15 16 20 21 21 21 21 21 21 21 21 21 21 31 18 18
30 21 21 21 21 21 21 21 21 21 21 31 18 18 19 18 18 18 18 18 19 18 18 18 18


