28 26 26 26 26 26 26 26 26 26 26 26 26 26 26 26 26 26 26 26 26 26 26 29 18
24 00 00 00 00 32 00 16 16 32 32 00 00 00 16 00 00 32 32 00 16 38 32 23 18
30 22 16 00 00 16 00 00 00 00 00 00 00 32 00 16 00 16 16 32 16 16 00 25 29
19 30 21 22 32 32 00 00 02 00 00 00 00 32 00 00 00 00 00 00 32 00 00 32 23
18 18 19 30 22 32 00 03 02 02 00 03 00 16 32 16 00 16 32 16 16 32 00 16 23
18 18 18 18 24 16 00 02 00 00 00 03 00 32 00 00 32 00 00 32 00 32 32 32 23
28 26 29 19 24 32 00 00 00 02 00 00 00 16 00 16 00 16 16 32 16 00 16 00 23
24 00 23 28 27 00 16 32 00 02 00 32 00 00 00 00 32 16 00 00 32 00 00 38 23
30 21 31 24 32 32 32 16 00 00 00 16 00 16 00 00 00 32 32 00 16 00 00 00 23
19 18 28 27 16 16 00 00 00 00 00 32 16 16 00 16 32 00 32 16 16 16 32 16 23
28 26 27 16 00 32 00 00 02 02 00 32 32 00 32 00 32 16 00 00 00 00 32 32 23
24 38 00 00 00 00 00 00 00 00 00 00 16 16 32 16 00 16 16 00 16 00 32 20 31
24 32 00 03 03 02 00 02 02 00 32 32 32 32 00 00 00 38 32 32 32 00 20 31 18
24 32 00 00 00 00 00 00 00 00 32 20 21 21 21 21 21 21 21 21 21 21 31 18 18
30 21 21 21 21 21 21 21 21 21 21 31 18 18 19 18 18 18 18 18 19 18 18 18 18


